.....................
.....................
..MMMMMMMMMMMMMMMMM..
..M...............M..
..M...............M..
.....................
.....................
.....................
..M...............M..
..M...............M..
..MMMMMMMMMMMMMMMMM..
.....................
.....................
.....................